
                  
 wwwwwwwwwwwwwwwwwwww
 ww    5  t t      ww
 ww 1          wwwwww      
 ww 2          w   ww    
 ww 3          w e ww
 ww            ww  ww
 ww                ww
 ww dd             ww
 wwwwwwwwwwwwwwwwwwww