
                  
 wwwwwwwwwwwwwwwwwwww
 ww                ww
 ww 1              ww      
 ww            ww  ww    
 ww 2          w e ww
 ww            wwwwww
 ww 3              ww
 ww          t   d ww
 wwwwwwwwwwwwwwwwwwww







